0 0 0 0 0 0 0 0 0 0 0 0 0 0 0 0 0 0 0 0 0 0 0 0 0 0 0 0 0 0 0 0 0 0 0 0 0 0 0 0 0 0 0 0 0 0 0 0 0 0 
0 0 0 0 0 0 0 0 0 0 0 0 0 0 0 0 0 0 0 0 0 0 0 0 0 0 0 0 0 0 0 0 0 0 0 0 0 0 0 0 0 0 0 0 0 0 0 0 0 0 
0 0 0 0 0 0 0 0 0 0 0 0 0 0 0 0 0 0 0 0 0 0 0 0 0 0 0 0 0 0 0 0 0 0 0 0 0 0 0 0 0 0 0 0 0 0 0 0 0 0 
0 0 0 0 0 0 0 0 0 0 0 0 0 0 0 0 0 0 0 0 0 0 0 0 0 0 0 0 0 0 0 0 0 0 0 0 0 0 0 0 0 0 0 0 0 0 0 0 0 0 
0 0 0 0 0 0 0 0 0 0 0 0 0 0 0 0 0 0 0 0 0 0 0 0 0 0 0 0 0 0 0 0 0 0 0 0 0 0 0 0 0 0 0 0 0 0 0 0 0 0 
0 0 0 0 0 0 0 0 0 0 0 0 0 0 0 0 0 0 0 0 0 0 0 0 0 0 0 0 0 0 0 0 0 0 0 0 0 0 0 0 0 0 0 0 0 0 0 0 0 0 
0 0 0 0 0 0 0 32 32 32 32 32 32 32 32 32 32 32 32 32 32 32 32 32 32 32 32 32 32 32 32 32 32 32 32 32 32 32 32 32 32 32 32 0 0 0 0 0 0 0 
0 0 0 0 0 0 0 32 32 32 32 32 32 32 32 32 32 32 32 32 32 32 32 32 17 17 17 32 32 32 32 32 32 32 32 32 32 32 32 32 32 32 32 0 0 0 0 0 0 0 
0 0 0 0 0 0 0 32 32 32 32 32 32 32 32 32 32 32 32 32 32 32 32 17 17 17 17 17 32 32 32 32 32 32 32 32 32 32 32 32 32 32 32 0 0 0 0 0 0 0 
0 0 0 0 0 0 0 32 32 32 32 32 32 32 32 32 32 32 32 32 32 32 32 17 17 17 17 17 32 32 32 32 32 32 32 32 32 32 32 32 32 32 32 0 0 0 0 0 0 0 
0 0 0 0 0 0 0 32 32 32 32 32 32 32 32 32 32 32 32 32 32 32 32 17 17 17 17 17 32 32 32 32 32 32 32 32 32 32 32 32 32 32 32 0 0 0 0 0 0 0 
0 0 0 0 0 0 0 32 32 32 32 32 32 32 32 32 32 32 32 32 32 32 32 32 17 17 17 32 32 32 32 32 32 32 32 32 32 32 32 32 32 32 32 0 0 0 0 0 0 0 
0 0 0 0 0 0 0 32 32 32 32 32 32 32 32 32 32 32 32 32 32 32 32 32 32 17 32 32 32 32 32 32 32 32 32 32 32 32 32 32 32 32 32 0 0 0 0 0 0 0 
0 0 0 0 0 0 0 32 32 32 32 32 32 32 32 32 32 32 32 32 32 32 32 32 32 17 32 32 32 32 32 32 32 32 32 32 32 32 32 32 32 32 32 0 0 0 0 0 0 0 
0 0 0 0 0 0 0 32 32 32 32 32 32 32 32 32 32 32 32 32 32 32 32 32 32 17 32 32 32 32 32 32 32 32 32 32 32 32 32 32 32 32 32 0 0 0 0 0 0 0 
0 0 0 0 0 0 0 32 32 32 32 32 32 32 32 32 32 32 32 32 32 32 32 32 32 17 32 32 32 32 32 32 32 32 32 32 32 32 32 32 32 32 32 0 0 0 0 0 0 0 
0 0 0 0 0 0 0 32 32 32 32 32 32 32 32 32 32 32 32 4 4 17 17 17 17 17 17 17 17 17 4 4 32 32 32 32 32 32 32 32 32 32 32 0 0 0 0 0 0 0 
0 0 0 0 0 0 0 32 32 32 32 32 32 32 32 32 32 32 4 4 17 17 17 17 17 17 17 17 17 17 17 4 4 32 32 32 32 32 32 32 32 32 32 0 0 0 0 0 0 0 
0 0 0 0 0 0 0 32 32 32 32 32 32 32 32 32 32 4 4 17 17 17 17 17 17 17 17 17 17 17 17 17 4 4 32 32 32 32 32 32 32 32 32 0 0 0 0 0 0 0 
0 0 0 0 0 0 0 32 32 32 32 32 32 32 32 32 4 4 4 17 17 17 17 17 17 17 17 17 17 17 17 17 4 4 4 32 32 32 32 32 32 32 32 0 0 0 0 0 0 0 
0 0 0 0 0 0 0 32 32 32 32 32 32 32 32 32 4 4 17 17 17 17 17 17 17 17 17 17 17 17 17 17 19 4 4 32 32 32 32 32 32 32 32 0 0 0 0 0 0 0 
0 0 0 0 0 0 0 32 32 32 32 32 32 32 32 32 4 4 17 17 17 17 17 17 17 17 17 17 17 17 17 17 17 4 4 32 32 32 32 32 32 32 32 0 0 0 0 0 0 0 
0 0 0 0 0 0 0 32 32 32 32 32 32 32 32 32 4 4 17 17 17 17 17 17 17 17 17 17 17 17 17 17 17 4 4 32 32 32 32 32 32 32 32 0 0 0 0 0 0 0 
0 0 0 0 0 0 0 32 32 32 32 32 32 32 32 32 4 4 17 17 17 17 17 17 17 17 17 17 17 17 17 17 17 4 4 32 32 32 32 32 32 32 32 0 0 0 0 0 0 0 
0 0 0 0 0 0 0 32 32 32 32 32 32 32 32 32 4 4 4 17 17 17 17 17 17 17 17 17 17 17 17 17 4 4 4 32 32 32 32 32 32 32 32 0 0 0 0 0 0 0 
0 0 0 0 0 0 0 32 32 32 32 32 32 32 32 32 32 4 4 17 17 17 17 17 17 17 17 17 17 17 17 17 4 4 32 32 32 32 32 32 32 32 32 0 0 0 0 0 0 0 
0 0 0 0 0 0 0 32 32 32 32 32 32 32 32 32 32 32 4 4 17 17 17 17 17 17 17 17 17 17 17 4 4 32 32 32 32 32 32 32 32 32 32 0 0 0 0 0 0 0 
0 0 0 0 0 0 0 32 32 32 32 32 32 32 32 32 32 32 32 4 4 17 17 17 17 17 17 17 17 17 4 4 32 32 32 32 32 32 32 32 32 32 32 0 0 0 0 0 0 0 
0 0 0 0 0 0 0 32 32 32 32 32 32 32 32 32 32 32 32 32 32 32 32 32 32 17 32 32 32 32 32 32 32 32 32 32 32 32 32 32 32 32 32 0 0 0 0 0 0 0 
0 0 0 0 0 0 0 32 32 32 32 32 32 32 32 32 32 32 32 32 32 32 32 32 32 17 32 32 32 32 32 32 32 32 32 32 32 32 32 32 32 32 32 0 0 0 0 0 0 0 
0 0 0 0 0 0 0 32 32 32 32 32 32 32 32 32 32 32 32 32 32 32 32 32 32 17 32 32 32 32 32 32 32 32 32 32 32 32 32 32 32 32 32 0 0 0 0 0 0 0 
0 0 0 0 0 0 0 32 32 32 32 32 32 32 32 32 32 32 32 32 32 32 32 32 17 17 17 32 32 32 32 32 32 32 32 32 32 32 32 32 32 32 32 0 0 0 0 0 0 0 
0 0 0 0 0 0 0 32 32 32 32 32 32 32 32 32 32 32 32 32 32 32 32 32 17 17 17 32 32 32 32 32 32 32 32 32 32 32 32 32 32 32 32 0 0 0 0 0 0 0 
0 0 0 0 0 0 0 32 32 32 32 32 32 32 32 32 32 32 32 32 32 32 32 32 17 17 17 32 32 32 32 32 32 32 32 32 32 32 32 32 32 32 32 0 0 0 0 0 0 0 
0 0 0 0 0 0 0 32 32 32 32 32 32 32 32 32 32 32 32 32 32 32 32 32 17 17 17 32 32 32 32 32 32 32 32 32 32 32 32 32 32 32 32 0 0 0 0 0 0 0 
0 0 0 0 0 0 0 32 32 32 32 32 32 32 32 32 32 32 32 32 32 32 32 32 17 17 17 32 32 32 32 32 32 32 32 32 32 32 32 32 32 32 32 0 0 0 0 0 0 0 
0 0 0 0 0 0 0 32 32 32 32 32 32 32 32 32 32 32 32 32 32 32 32 32 17 17 17 32 32 32 32 32 32 32 32 32 32 32 32 32 32 32 32 0 0 0 0 0 0 0 
0 0 0 0 0 0 0 32 32 32 32 32 32 32 32 32 32 32 32 32 32 32 32 32 17 17 17 32 32 32 32 32 32 32 32 32 32 32 32 32 32 32 32 0 0 0 0 0 0 0 
0 0 0 0 0 0 0 32 32 32 32 32 32 32 32 32 32 32 32 32 32 32 32 32 17 17 17 32 32 32 32 32 32 32 32 32 32 32 32 32 32 32 32 0 0 0 0 0 0 0 
0 0 0 0 0 0 0 32 32 32 32 32 32 32 32 32 32 32 32 17 17 17 17 17 17 17 17 17 17 17 4 4 4 32 32 32 32 32 32 32 32 32 32 0 0 0 0 0 0 0 
0 0 0 0 0 0 0 32 32 32 32 32 32 32 32 32 32 32 36 17 17 17 17 17 17 17 17 17 17 17 4 4 4 32 32 32 32 32 32 32 32 32 32 0 0 0 0 0 0 0 
0 0 0 0 0 0 0 32 32 32 32 32 32 32 32 32 32 32 32 17 17 17 17 17 17 17 17 17 17 17 4 4 4 32 32 32 32 32 32 32 32 32 32 0 0 0 0 0 0 0 
0 0 0 0 0 0 0 32 32 32 32 32 32 32 32 32 32 32 32 32 32 32 32 32 32 32 32 32 32 32 32 32 32 32 32 32 32 32 32 32 32 32 32 0 0 0 0 0 0 0 
0 0 0 0 0 0 0 32 32 32 32 32 32 32 32 32 32 32 32 32 32 32 32 32 32 32 32 32 32 32 32 32 32 32 32 32 32 32 32 32 32 32 32 0 0 0 0 0 0 0 
0 0 0 0 0 0 0 0 0 0 0 0 0 0 0 0 0 0 0 0 0 0 0 0 0 0 0 0 0 0 0 0 0 0 0 0 0 0 0 0 0 0 0 0 0 0 0 0 0 0 
0 0 0 0 0 0 0 0 0 0 0 0 0 0 0 0 0 0 0 0 0 0 0 0 0 0 0 0 0 0 0 0 0 0 0 0 0 0 0 0 0 0 0 0 0 0 0 0 0 0 
0 0 0 0 0 0 0 0 0 0 0 0 0 0 0 0 0 0 0 0 0 0 0 0 0 0 0 0 0 0 0 0 0 0 0 0 0 0 0 0 0 0 0 0 0 0 0 0 0 0 
0 0 0 0 0 0 0 0 0 0 0 0 0 0 0 0 0 0 0 0 0 0 0 0 0 0 0 0 0 0 0 0 0 0 0 0 0 0 0 0 0 0 0 0 0 0 0 0 0 0 
0 0 0 0 0 0 0 0 0 0 0 0 0 0 0 0 0 0 0 0 0 0 0 0 0 0 0 0 0 0 0 0 0 0 0 0 0 0 0 0 0 0 0 0 0 0 0 0 0 0 
0 0 0 0 0 0 0 0 0 0 0 0 0 0 0 0 0 0 0 0 0 0 0 0 0 0 0 0 0 0 0 0 0 0 0 0 0 0 0 0 0 0 0 0 0 0 0 0 0 0 
