19 19 19 19 19 19 19 19 19 19 19 19 19 19 19 19 19 19 19 19 19 19 19 19 19 19 19 19 19 19 19 19 19 19 19 19 19 19 19 19 19 19 19 19 19 19 19 19 19 19 
19 19 19 19 19 19 19 19 19 19 19 19 19 19 19 19 19 19 19 19 19 19 19 19 19 19 19 19 19 19 19 19 19 19 19 19 19 19 19 19 19 19 19 19 19 19 19 19 19 19 
19 19 19 19 19 19 19 19 19 19 19 19 19 19 19 19 19 19 19 19 19 19 19 19 19 19 19 19 19 19 19 19 19 19 19 19 19 19 19 19 19 19 19 19 19 19 19 19 19 19 
19 19 19 19 19 19 19 19 19 19 19 19 19 19 19 19 19 19 19 19 19 19 19 19 19 19 19 19 19 19 19 19 19 19 19 19 19 19 19 19 19 19 19 19 19 19 19 19 19 19 
19 19 19 19 19 19 19 19 19 19 19 19 19 19 19 19 19 19 19 19 19 19 19 19 19 19 19 19 19 19 19 19 19 19 19 19 19 19 19 19 19 19 19 19 19 19 19 19 19 19 
19 19 19 19 19 19 19 19 19 19 19 19 19 19 19 19 19 19 19 19 19 19 19 19 19 19 19 19 19 19 19 19 19 19 19 19 19 19 19 19 19 19 19 19 19 19 19 19 19 19 
19 19 19 19 19 19 4 4 4 4 4 4 4 4 4 4 4 4 4 4 4 4 4 4 4 4 4 4 4 4 4 4 4 4 4 4 4 4 4 4 4 4 4 4 19 19 19 19 19 19 
19 19 19 19 19 19 4 4 18 18 32 32 32 32 32 18 18 18 18 18 4 4 4 4 4 4 4 18 18 18 18 4 4 18 18 18 18 18 18 18 18 18 4 4 19 19 19 19 19 19 
19 19 19 19 19 19 4 18 18 18 32 0 0 0 32 16 16 16 16 18 4 4 4 4 4 4 4 18 16 16 16 16 16 16 16 18 18 18 18 18 18 18 4 4 19 19 19 19 19 19 
19 19 19 19 19 19 4 18 18 18 32 0 0 0 32 16 16 16 16 18 4 4 4 4 4 4 4 18 16 16 16 16 16 16 16 4 4 4 4 4 4 4 4 4 19 19 19 19 19 19 
19 19 19 19 19 19 4 18 18 18 32 32 32 32 32 16 16 16 16 18 18 18 4 4 4 18 18 18 16 16 16 16 16 16 16 1 1 1 1 1 1 1 4 4 19 19 19 19 19 19 
19 19 19 19 19 19 4 18 18 18 32 32 32 32 32 16 16 16 16 18 18 18 18 18 18 18 18 18 16 16 16 16 16 16 16 1 1 12 10 13 1 18 4 4 19 19 19 19 19 19 
19 19 19 19 19 19 4 18 18 18 32 32 17 32 32 16 16 16 18 18 18 18 18 18 18 18 18 18 18 16 16 16 16 16 1 1 1 8 3 7 18 18 4 4 19 19 19 19 19 19 
19 19 19 19 19 19 4 18 18 18 16 16 1 16 16 16 16 16 16 16 16 16 1 1 1 16 16 16 16 16 16 16 16 16 16 16 16 8 3 7 18 18 4 4 19 19 19 19 19 19 
19 19 19 19 19 19 4 18 18 1 16 16 1 16 16 16 16 16 16 16 16 16 12 10 13 16 16 16 16 16 16 16 16 16 16 16 16 8 3 7 18 18 4 4 19 19 19 19 19 19 
19 19 19 19 19 19 4 18 18 1 16 16 1 16 16 16 2 1 1 16 16 16 8 3 7 16 16 16 16 16 16 16 16 16 16 16 16 8 3 7 18 18 4 4 19 19 19 19 19 19 
19 19 19 19 19 19 4 18 18 1 16 16 1 16 16 16 1 1 1 1 1 1 8 3 7 1 1 17 16 16 16 16 16 16 16 16 16 8 3 7 18 18 4 4 19 19 19 19 19 19 
19 19 19 19 19 19 4 18 18 16 16 16 1 16 16 16 1 2 1 16 16 16 8 3 7 16 16 16 16 16 16 16 16 16 16 1 2 8 3 7 18 18 4 4 19 19 19 19 19 19 
19 19 19 19 19 19 4 18 18 16 1 1 1 16 16 16 16 16 16 16 16 1 8 3 7 2 16 16 16 16 16 16 16 16 1 12 10 3 3 7 18 18 4 4 19 19 19 19 19 19 
19 19 19 19 19 19 4 18 18 16 2 16 16 16 16 16 16 16 16 16 1 2 8 3 7 1 1 16 16 16 16 16 16 16 1 8 3 3 5 15 18 18 4 4 19 19 19 19 19 19 
19 19 19 19 19 19 4 18 18 16 1 16 16 1 2 1 1 6 1 16 1 1 8 3 3 10 10 10 10 13 6 12 10 10 10 3 3 7 1 1 18 18 4 4 19 19 19 19 19 19 
19 19 19 19 19 19 4 18 18 16 1 16 1 1 1 1 1 6 1 1 1 1 8 3 3 3 3 3 3 7 6 8 3 3 3 3 3 7 1 1 18 18 4 4 19 19 19 19 19 19 
19 19 19 19 19 19 4 18 18 16 6 16 16 1 1 2 1 6 1 16 1 1 8 3 3 5 5 5 5 15 6 14 5 5 5 3 3 7 1 18 18 18 4 4 19 19 19 19 19 19 
19 19 19 19 19 19 4 18 18 16 1 16 16 1 1 16 16 16 16 16 2 1 8 3 7 1 1 16 16 16 16 16 16 16 1 8 3 7 1 18 18 18 4 4 19 19 19 19 19 19 
19 19 19 19 19 19 4 18 18 16 1 16 16 1 1 16 16 16 16 16 16 1 8 3 7 1 16 16 16 16 16 16 16 16 1 8 3 7 1 18 18 18 4 4 19 19 19 19 19 19 
19 19 19 19 19 19 4 18 18 16 2 16 16 1 16 16 16 16 16 16 16 16 8 3 7 16 16 16 16 16 16 1 16 16 16 8 3 7 1 18 18 18 4 4 19 19 19 19 19 19 
19 19 19 19 19 19 4 18 18 16 1 16 16 1 16 16 16 16 16 16 16 16 8 3 7 16 16 16 16 16 16 1 16 16 16 8 3 7 1 18 18 18 4 4 19 19 19 19 19 19 
19 19 19 19 19 19 4 18 18 16 1 16 16 1 16 16 16 16 16 16 16 16 8 3 7 1 1 1 1 2 1 1 16 16 16 8 3 7 1 18 18 18 4 4 19 19 19 19 19 19 
19 19 19 19 19 19 4 18 18 16 1 16 16 1 16 16 16 16 16 16 16 16 8 3 7 16 16 1 16 16 16 16 16 16 16 14 5 15 1 18 18 18 4 4 19 19 19 19 19 19 
19 19 19 19 19 19 4 18 18 16 1 1 1 1 1 1 16 16 16 16 16 16 8 3 7 16 16 1 16 16 16 16 16 16 16 1 1 1 1 18 18 18 4 4 19 19 19 19 19 19 
19 19 19 19 19 19 4 18 18 16 1 2 1 1 1 1 16 16 16 16 16 16 8 3 7 16 16 1 16 2 1 1 16 16 16 1 1 1 1 4 4 4 4 4 19 19 19 19 19 19 
19 19 19 19 19 19 4 18 18 16 1 1 1 1 1 1 16 16 16 16 16 16 8 3 7 16 16 1 16 1 1 1 16 16 16 1 1 1 1 18 18 18 4 4 19 19 19 19 19 19 
19 19 19 19 19 19 4 18 18 16 1 1 1 2 1 1 16 16 16 16 16 16 8 3 7 16 16 1 1 1 1 1 16 16 16 1 1 1 1 18 18 18 4 4 19 19 19 19 19 19 
19 19 19 19 19 19 4 18 18 16 1 2 1 1 1 1 16 16 16 16 16 16 8 3 7 16 16 1 1 1 1 2 16 16 16 1 1 2 1 18 18 18 4 4 19 19 19 19 19 19 
19 19 19 19 19 19 4 18 18 16 1 1 1 1 1 2 16 16 16 16 16 16 8 3 7 16 16 16 16 16 16 16 16 16 16 1 1 1 1 18 18 18 4 4 19 19 19 19 19 19 
19 19 19 19 19 19 4 18 16 16 16 16 16 16 16 16 16 16 16 16 16 16 14 5 15 16 16 16 16 16 16 16 16 16 16 1 1 1 1 18 18 18 4 4 19 19 19 19 19 19 
19 19 19 19 19 19 4 18 16 16 16 16 16 16 16 16 16 16 16 16 1 1 1 1 1 1 1 16 16 16 17 16 16 16 1 1 1 1 1 18 18 18 4 4 19 19 19 19 19 19 
19 19 19 19 19 19 4 18 16 16 16 16 16 16 16 16 16 16 16 1 1 1 1 2 2 1 1 1 16 16 1 16 16 1 1 2 1 1 1 18 18 18 4 4 19 19 19 19 19 19 
19 19 19 19 19 19 4 4 16 16 16 16 16 16 16 16 16 16 16 1 1 1 1 2 1 1 1 1 16 16 1 16 1 1 1 1 1 1 1 1 18 18 4 4 19 19 19 19 19 19 
19 19 19 19 19 19 4 4 16 16 33 16 16 16 16 16 16 16 16 1 1 2 1 1 1 1 2 1 1 1 1 1 1 1 1 1 1 16 1 1 18 18 4 4 19 19 19 19 19 19 
19 19 19 19 19 19 4 4 16 16 1 1 16 16 16 16 16 16 1 1 2 1 1 1 1 1 1 1 1 1 1 1 1 1 16 1 2 1 1 1 18 18 4 4 19 19 19 19 19 19 
19 19 19 19 19 19 4 4 16 16 1 2 1 16 16 16 16 1 1 1 1 1 1 1 2 1 1 1 1 1 1 1 1 1 1 1 1 1 2 1 18 18 4 4 19 19 19 19 19 19 
19 19 19 19 19 19 4 4 16 16 1 1 1 1 1 1 1 1 1 1 1 1 1 1 1 1 18 18 18 18 18 1 1 16 2 1 16 1 1 1 18 18 4 4 19 19 19 19 19 19 
19 19 19 19 19 19 4 4 18 18 18 18 18 18 18 18 18 18 18 18 18 18 18 18 18 18 18 18 18 18 18 18 1 1 1 1 1 1 1 1 18 18 4 4 19 19 19 19 19 19 
19 19 19 19 19 19 4 4 4 18 18 18 18 18 18 18 18 18 18 18 18 18 18 18 18 18 18 18 18 18 18 18 18 18 18 18 18 18 18 18 18 18 4 4 19 19 19 19 19 19 
19 19 19 19 19 19 4 4 4 4 4 4 4 4 4 4 4 4 4 4 4 4 4 4 4 4 4 4 4 4 4 4 4 4 4 4 4 4 4 4 4 4 4 4 19 19 19 19 19 19 
19 19 19 19 19 19 19 19 19 19 19 19 19 19 19 19 19 19 19 19 19 19 19 19 19 19 19 19 19 19 19 19 19 19 19 19 19 19 19 19 19 19 19 19 19 19 19 19 19 19 
19 19 19 19 19 19 19 19 19 19 19 19 19 19 19 19 19 19 19 19 19 19 19 19 19 19 19 19 19 19 19 19 19 19 19 19 19 19 19 19 19 19 19 19 19 19 19 19 19 19 
19 19 19 19 19 19 19 19 19 19 19 19 19 19 19 19 19 19 19 19 19 19 19 19 19 19 19 19 19 19 19 19 19 19 19 19 19 19 19 19 19 19 19 19 19 19 19 19 19 19 
19 19 19 19 19 19 19 19 19 19 19 19 19 19 19 19 19 19 19 19 19 19 19 19 19 19 19 19 19 19 19 19 19 19 19 19 19 19 19 19 19 19 19 19 19 19 19 19 19 19 
