19 19 19 19 19 19 19 19 19 19 19 19 19 19 19 19 19 19 19 19 19 19 19 19 19 19 19 19 19 19 19 19 19 19 19 19 19 19 19 19 19 19 19 19 19 19 19 19 19 19 
19 19 19 19 19 19 19 19 19 19 19 19 19 19 19 19 19 19 19 19 19 19 19 19 19 19 19 19 19 19 19 19 19 19 19 19 19 19 19 19 19 19 19 19 19 19 19 19 19 19 
19 19 19 19 19 19 19 19 19 19 19 19 19 19 19 19 19 19 19 19 19 19 19 19 19 19 19 19 19 19 19 19 19 19 19 19 19 19 19 19 19 19 19 19 19 19 19 19 19 19 
19 19 19 19 19 19 19 19 19 19 19 19 19 19 19 19 19 19 19 19 19 19 19 19 19 19 19 19 19 19 19 19 19 19 19 19 19 19 19 19 19 19 19 19 19 19 19 19 19 19 
19 19 19 19 19 19 19 19 19 19 19 19 19 19 19 19 19 19 19 19 19 19 19 19 19 19 19 19 19 19 19 19 19 19 19 19 19 19 19 19 19 19 19 19 19 19 19 19 19 19 
19 19 19 19 19 19 19 19 19 19 19 19 19 19 19 19 19 19 19 19 19 19 19 19 19 19 19 19 19 19 19 19 19 19 19 19 19 19 19 19 19 19 19 19 19 19 19 19 19 19 
19 19 19 19 19 19 19 19 19 19 19 19 19 19 19 19 19 19 19 19 19 19 19 19 19 19 19 19 19 19 19 19 19 19 19 19 19 19 19 19 19 19 19 19 19 19 19 19 19 19 
19 19 19 19 19 19 19 19 19 16 32 32 32 32 32 16 1 19 1 16 1 1 1 1 1 1 1 1 19 19 19 1 16 1 12 10 10 10 10 10 10 13 19 19 19 19 19 19 19 19 
19 19 19 19 19 19 19 19 19 16 32 17 17 17 32 16 16 16 16 16 1 1 1 1 1 1 1 16 16 16 16 16 16 16 8 3 3 3 3 3 3 7 19 19 19 19 19 19 19 19 
19 19 19 19 19 19 19 19 19 16 32 17 36 17 32 16 16 16 16 16 1 19 19 19 19 19 1 16 16 16 16 16 16 16 0 0 0 0 0 0 0 0 19 19 19 19 19 19 19 19 
19 19 19 19 19 19 19 19 19 16 32 17 17 17 32 16 16 16 16 16 1 19 19 19 19 19 1 16 16 16 16 16 16 16 8 3 3 3 3 3 3 7 19 19 19 19 19 19 19 19 
19 19 19 19 19 19 19 19 19 16 32 17 17 17 32 16 16 16 16 16 1 1 19 19 19 1 1 16 16 16 16 16 16 16 8 3 3 3 3 3 3 7 19 19 19 19 19 19 19 19 
19 19 19 19 19 19 19 19 19 16 32 32 17 32 32 16 16 16 16 16 1 1 12 10 13 1 1 1 1 16 16 16 1 1 14 5 5 6 3 4 5 15 19 19 19 19 19 19 19 19 
19 19 19 19 19 19 19 19 19 16 16 16 1 16 16 16 16 16 16 16 16 16 8 3 7 16 16 16 16 16 16 16 16 16 16 16 16 8 3 7 1 1 19 19 19 19 19 19 19 19 
19 19 19 19 19 19 19 19 19 1 16 16 1 16 16 16 16 16 16 16 16 16 8 3 7 16 16 16 16 16 16 16 16 16 16 16 16 8 3 7 19 19 19 19 19 19 19 19 19 19 
19 19 19 19 19 19 19 19 19 19 16 16 1 16 16 16 16 16 16 16 16 16 8 3 7 16 16 16 16 16 16 16 16 16 16 16 16 8 3 7 19 19 19 19 19 19 19 19 19 19 
19 19 19 19 19 19 19 19 19 1 16 16 1 16 16 16 16 16 1 1 1 1 8 3 7 1 1 17 16 16 16 16 16 16 16 16 16 8 3 7 19 19 19 19 19 19 19 19 19 19 
19 19 19 19 19 19 19 19 1 16 16 16 1 16 16 16 16 16 16 16 16 16 8 3 7 16 16 16 16 16 16 16 16 16 16 12 10 11 3 7 19 19 19 19 19 19 19 19 19 19 
19 19 19 19 19 19 19 19 16 16 1 1 1 16 16 16 16 16 16 16 16 16 8 3 7 16 16 16 16 16 16 16 16 16 16 8 3 3 3 7 19 19 19 19 19 19 19 19 19 19 
19 19 19 19 19 19 19 19 16 16 1 16 16 16 16 16 16 16 16 16 16 1 8 3 7 1 16 16 16 16 16 16 16 16 16 8 3 4 5 15 19 19 19 19 19 19 19 19 19 19 
19 19 19 19 19 19 19 19 16 16 1 16 16 1 12 10 10 13 0 12 10 10 11 3 9 10 10 10 10 13 1 1 1 12 10 11 3 7 1 1 19 19 19 19 19 19 19 19 19 19 
19 19 19 19 19 19 19 19 16 16 1 16 16 1 8 3 3 7 0 8 3 3 3 3 3 3 3 3 3 7 1 1 1 8 3 3 3 7 1 1 19 19 19 19 19 19 19 19 19 19 
19 19 19 19 19 19 19 19 16 16 0 16 16 1 14 5 5 15 0 14 5 5 6 3 4 5 5 5 5 15 1 1 1 14 5 6 3 7 2 19 19 19 19 19 19 19 19 19 19 19 
19 19 19 19 19 19 19 19 1 16 1 16 16 1 16 16 16 16 16 16 16 1 8 3 7 1 16 16 16 16 16 16 16 16 16 8 3 7 1 19 19 19 19 19 19 19 19 19 19 19 
19 19 19 19 19 19 19 19 19 16 1 16 16 1 16 16 16 16 16 16 16 16 8 3 7 16 16 16 16 16 16 16 16 16 16 8 3 7 1 19 19 19 19 19 19 19 19 19 19 19 
19 19 19 19 19 19 19 19 1 16 1 16 16 1 1 16 16 16 16 16 16 16 8 3 7 16 16 16 16 16 16 1 16 16 16 8 3 7 1 19 19 19 19 19 19 19 19 19 19 19 
19 19 19 19 19 19 19 19 16 16 1 16 16 16 1 16 16 16 16 16 16 16 8 3 7 16 16 16 16 16 16 1 16 16 16 8 3 7 1 19 19 19 19 19 19 19 19 19 19 19 
19 19 19 19 19 19 19 19 16 16 1 16 16 16 1 16 16 16 16 16 16 16 8 3 7 1 1 1 1 1 1 1 16 16 16 8 3 7 1 19 19 19 19 19 19 19 19 19 19 19 
19 19 19 19 19 19 19 19 16 16 1 16 16 16 1 16 16 16 16 16 16 16 8 3 7 16 16 1 1 16 16 16 16 16 16 8 3 7 1 19 19 19 19 19 19 19 19 19 19 19 
19 19 19 19 19 19 19 19 16 16 1 1 1 1 1 1 16 16 16 16 16 16 8 3 7 16 16 1 1 1 1 1 16 16 16 14 5 15 1 19 19 19 19 19 19 19 19 19 19 19 
19 19 19 19 19 19 19 19 16 16 1 2 1 1 1 1 16 16 16 16 16 16 8 3 7 16 16 1 1 1 1 1 16 16 16 16 1 16 1 19 19 19 19 19 19 19 19 19 19 19 
19 19 19 19 19 19 19 19 1 16 1 1 1 1 1 1 16 16 16 16 16 16 8 3 7 16 16 1 1 1 1 1 16 16 16 1 1 1 19 19 19 19 19 19 19 19 19 19 19 19 
19 19 19 19 19 19 19 19 19 16 1 1 1 2 1 1 16 16 16 16 16 16 8 3 7 16 16 16 16 16 16 16 16 16 16 1 1 1 19 19 19 19 19 19 19 19 19 19 19 19 
19 19 19 19 19 19 19 19 19 16 1 1 1 1 1 1 16 16 16 16 16 16 8 3 7 16 16 16 16 16 16 16 16 16 16 1 1 2 19 19 19 19 19 19 19 19 19 19 19 19 
19 19 19 19 19 19 19 19 19 16 1 1 1 1 1 1 16 16 16 16 16 16 8 3 7 16 16 16 16 16 16 16 16 16 16 1 1 1 19 19 19 19 19 19 19 19 19 19 19 19 
19 19 19 19 19 19 19 19 1 16 16 16 16 16 16 16 16 16 16 16 16 16 14 5 15 16 16 16 16 16 16 16 16 16 16 1 1 1 1 19 19 19 19 19 19 19 19 19 19 19 
19 19 19 19 19 19 19 19 16 16 16 16 16 16 16 16 16 16 16 16 1 1 1 1 1 1 1 16 16 16 17 16 16 16 1 1 1 1 1 1 19 19 19 19 19 19 19 19 19 19 
19 19 19 19 19 19 19 19 16 16 16 16 16 16 16 16 16 16 16 1 1 1 1 2 1 1 1 1 16 16 1 16 16 1 1 2 1 1 1 1 19 19 19 19 19 19 19 19 19 19 
19 19 19 19 19 19 19 19 16 16 16 16 16 16 16 16 16 16 16 1 1 1 1 1 1 1 1 1 16 16 1 16 1 1 1 1 1 1 1 1 19 19 19 19 19 19 19 19 19 19 
19 19 19 19 19 19 19 19 16 16 33 16 16 16 16 16 16 16 16 1 1 1 1 1 1 1 2 1 1 1 1 1 1 1 1 1 1 16 1 2 19 19 19 19 19 19 19 19 19 19 
19 19 19 19 19 19 19 19 16 16 1 16 16 1 1 1 1 1 1 1 2 1 1 1 1 1 1 1 1 1 1 1 1 1 16 1 1 1 1 1 19 19 19 19 19 19 19 19 19 19 
19 19 19 19 19 19 19 19 16 16 1 1 1 1 16 1 1 1 1 1 1 1 1 1 1 1 1 1 1 1 1 1 1 1 1 1 1 1 1 1 19 19 19 19 19 19 19 19 19 19 
19 19 19 19 19 19 19 19 16 16 16 16 16 16 1 19 19 19 19 1 1 1 1 1 1 1 1 19 19 19 19 1 1 16 1 1 16 1 1 1 19 19 19 19 19 19 19 19 19 19 
19 19 19 19 19 19 19 19 1 1 1 1 1 1 19 19 19 19 19 19 1 1 1 1 1 1 19 19 19 19 19 1 1 1 1 1 1 1 1 1 19 19 19 19 19 19 19 19 19 19 
19 19 19 19 19 19 19 19 19 19 19 19 19 19 19 19 19 19 19 19 19 19 19 19 19 19 19 19 19 19 19 19 1 1 1 1 1 1 19 19 19 19 19 19 19 19 19 19 19 19 
19 19 19 19 19 19 19 19 19 19 19 19 19 19 19 19 19 19 19 19 19 19 19 19 19 19 19 19 19 19 19 19 19 19 19 19 19 19 19 19 19 19 19 19 19 19 19 19 19 19 
19 19 19 19 19 19 19 19 19 19 19 19 19 19 19 19 19 19 19 19 19 19 19 19 19 19 19 19 19 19 19 19 19 19 19 19 19 19 19 19 19 19 19 19 19 19 19 19 19 19 
19 19 19 19 19 19 19 19 19 19 19 19 19 19 19 19 19 19 19 19 19 19 19 19 19 19 19 19 19 19 19 19 19 19 19 19 19 19 19 19 19 19 19 19 19 19 19 19 19 19 
19 19 19 19 19 19 19 19 19 19 19 19 19 19 19 19 19 19 19 19 19 19 19 19 19 19 19 19 19 19 19 19 19 19 19 19 19 19 19 19 19 19 19 19 19 19 19 19 19 19 
19 19 19 19 19 19 19 19 19 19 19 19 19 19 19 19 19 19 19 19 19 19 19 19 19 19 19 19 19 19 19 19 19 19 19 19 19 19 19 19 19 19 19 19 19 19 19 19 19 19 
